000000000000000000000000000000000000000000000000000000000000000000000000000
000000000000000000000000000000000000000000000000000000000000000000000000000
000000000000000000000000000000000000000000000000000000000000000000000000000
000000000000000000000000000000000000000000000000000000000000000000000000000
000000000000000000000000000000000000000000000000000000000000000000000000000
000000000000000000000000000000000000000000000000000000000000000000000000000
000000000000000000000000000000000000000000000000000000000000000000000000000
000000000000000000000000000000000000000000000000000000000000000000000000000
000000000000000000000000000000000000000000000000000000000000000000000000000
000000000000000000000000000000000000000000000000000000000000000000000000000
000000000000000000000000000000000000000000000000000000000000000000000000000
000000000000000000000000000000000000000000000000000000000000000000000000000
000000000000000000000000000000000000000000000000000000000000000000000000000
022222000000000000000000000000000000000000000000000000022222000000000000000
011100000000000000000000000000000000000000000000000000000111000000000000000
011100000000000000000000000000000000000000000000000000000111000000000000000
011100000000000000000000000000000000000000000000000000000111000000000000000
011100000000000000000000000000000000000000000000000000000111000000000000000
011100000000000000000000000000000000000000000000000000000111000000000000000
011100000000000000000000000000000000000000000000000000000111000000000000000
011100000000000000000000000000000000000000000000000000000111000000000000000
011100000000000000000000000000000000000000000000000000000111000000000000000
011100000000000000000000000000000000000000000000000000000111000000000000000
011100000000000000000000000000000000000000000000000000000111000000000000000
011100000000000000000000000000000000000000000000000000000111000000000000000
011100000000000000000000000000000000000000000000000000000111000000000000000
011100000000000000000000000000000000000000000000000000000111000000000000000
011100000000000000000000000002220000000000000000000000000111000000000000000
011100000000000000000000000001110000000000000000000000000111000000000000000
011100000000000000000000000001110000000000000000000000000111000000000000000
011100000000000000000000002000100020000000000000000000000111000000000000000
011100000000000000000000021000000012000000000000000000000111000000000000000
011100000000000000000000011200000211000000000000000000000111000000000000000
011100002222222222222220011122022111002222222222222220000111000000000000000
011100021111111111111112011111011111021111111111111112000111000000000000000
011100011111111111111111011111011111011111111111111111000111000000000000000
011100011111111111111111001111011110011111111111111111000111000000000000000
011100011111111111111111000011011000011111111111111111000111000000000000000
011100011111111111111111000000000000011111111111111111000111000000000000000
011100011111111111111111000000000000011111111111111111000111000000000000000
011100011111111111111111000000000000011111111111111111000111000000000000000
011100011111111111111111000000000000011111111111111111000111000000000000000
011100011111111111111111000000000000011111111111111111000111000000000000000
011100011111111111111111000000000000011111111111111111000111000000000000000
011100011111111111111111000000000000011111111111111111000111000000000000000
011100011111111111111111000000000000011111111111111111000111000000000000000
011100011111111111111111000000000000011111111111111111000111000000000000000
011100011111111111111111000000000000011111111111111111000111000000000000000
011100011111111111111111000000000000011111111111111111000111000000000000000
011100011111111111111111000000000000011111111111111111000111000000000000000
