000000000000000000000000000000000000000000000000000000000000000000000000000
000000000000000000000000000000000000000000000000000000000000000000000000000
000000000000000000000000000000000000000000000000000000000000000000000000000
000000000000000000000000000000000000000000000000000000000000000000000000000
000000000000000000000000000000000000000000000000000000000000000000000000000
000000000000000000000000000000000000000000000000000000000000000000000000000
000000000000000000000000000000000000000000000000000000000000000000000000000
000000000000000000000000000000000000000000000000000000000000000000000000000
000000000000000000000000000000000000000000000000000000000000000000000000000
000000000000000000000000000000000000000000000000000000000000000000000000000
000000000000000000000000000000000000000000000000000000000000000000000000000
000000000000000000000000000000000000000000000000000000000000000000000000000
000000000000000000000000000000000000000000000000000000000000000000000000000
000000000000000000000000000000000000000000000000000000000000000000000000000
000000000000000000000000000000000000000000000000000000000000000000000000000
000000000000000000000000000000000000000000000000000000000000000000000000000
000000000000000000000000000000000000000000000000000000000000000000000000000
000000000000000000000000000000000000000000000000000000000000000000000000000
000000000000000000000000000000000000000000000000000000000000000000000000000
000000000000000000000000000000000000000000000000000000000000000000000000000
000000000000000000002222000000000000022220000000000000000000000000000000000
000000000000000000000000000000000000000000000000000000000000000000000000000
000000000000000000000000000000000000000000000000000000000000000000000000000
000000000000000002222222222000000022222222220000000000000000000000000000000
000000000000000021111111111200000211111111112000000000000000000000000000000
000000000000000000011111111120002111111111000000000000000000000000000000000
000000000000222000000000111100000111100000000022200000000000000000000000000
000000000002111200000000011100000111000000000211120000000000000000000000000
000000000000011000000000001120002110000000000011000000000000000000000000000
000000000020000000000000001100000110000000000000002000000000000000000000000
000000022210000000000000000100000100000000000000001222000000000000000000000
000000211100000000000000000020002000000000000000000111200000000000000000000
000000000000000000000000000000000000000000000000000000000000000000000000000
022220022222222222200022200000000000222000222222222222002222000000000000000
001112001111111111000001122002220022110000011111111110021110000000000000000
000001001111111000000000011000100011000000000011111110010000000000000000000
000001200000000000000000000200000200000000000000000000210000000000000000000
000000120000000000000000000000000000000000000000000002100000000000000000000
000000112222222222000002222222222222220000022222222221100000000000000000000
000000011111111111200021111111111111112000211111111111000000000000000000000
000000001111111110000000111111111111100000001111111110000000000000000000000
000000000000000000000000000000000000000000000000000000000000000000000000000
000000000000000000000000000000000000000000000000000000000000000000000000000
000000000000000000000000000000000000000000000000000000000000000000000000000
000000000000000000000000000000000000000000000000000000000000000000000000000
000000000000000000000000000000000000000000000000000000000000000000000000000
000000000000000000000000000000000000000000000000000000000000000000000000000
000000000000000000000000000000000000000000000000000000000000000000000000000
000000000000000000000000000000000000000000000000000000000000000000000000000
000000000000000000000000000000000000000000000000000000000000000000000000000
