000000000000000000000000000000000000000000000000000000000000000000000000000
000000000000000000000000000000000000000000000000000000000000000000000000000
000000000000000000000000000000000000000000000000000000000000000000000000000
000000000000000000000000000000000000000000000000000000000000000000000000000
000000000000000000000000000000000000000000000000000000000000000000000000000
000000000000000000000000000000000000000000000000000000000000000000000000000
000000000000000000000000000000000000000000000000000000000000000000000000000
000000000000000000000000000000000000000000000000000000000000000000000000000
000000000000000000000000000000000000000000000000000000000000000000000000000
000000000000000000000000000000000000000000000000000000000000000000000000000
000000000000000000000000000000000000000000000000000000000000000000000000000
000000000000000000000000000000000000000000000000000000000000000000000000000
000000000000000000000000000000000000000000000000000000000000000000000000000
000000000000000000000000000000000000000000000000000000000000000000000000000
000000000000000000000000000000000000000000000000000000000000000000000000000
000000000000000000000000000000000000000000000000000000000000000000000000000
000000000000000000000000000000000000000000000000000000000000000000000000000
000000000000000000000000000000000000000000000000000000000000000000000000000
000000000000000000000000000000000000000000000000000000000000000000000000000
000000000000000000000000000000000000000000000000000000000000000000000000000
000000000000000000000000000000000000000000000000000000000000000000000000000
000000000000000000200000000000000000000000000000000000000000000000000000000
000000000000000000100000000000000000000020000000000000000000000000000000000
000000000000000002100000000000000000000010000000000000000000000000000000000
000000000000000001100000000000000000000010000000000000000000000000000000000
000000000000000001100000000000000000000012000000000000000000000000000000000
000000000000000001120000000000000000000011000000000000000000000000000000000
000000000000000001110000000000000000000011000000000000000000000000000000000
000000000000000001110000000000000000000011000000000000000000000000000000000
000000000000000001110000000000000000000211000000000000000000000000000000000
000000000000000001110000000000022220000111000000000000000000000000000000000
000000000000000001110002220000011100000111000000000000000000000000000000000
000000000000000001110000112000001000000111000000000000000000000000000000000
000000000000000001110000001200000000000111000000000000000000000000000000000
000000000000000001112000000000000000000111000000000000000000000000000000000
000000000000000001111000000000000000000111000000000000000000000000000000000
000000000000000001111000000222220000002111000000000000000000000000000000000
000000000000000001111000200011100020001111000000000000000000000000000000000
000000000000000001111202100000000010221111000000000000000000000000000000000
000000000000000001111121100000000212111111000000000000000000000000000000000
000000000000000001111111122000002111111111000000000000000000000000000000000
000000000000000001111111111222221111111111000000000000000000000000000000000
000000000000000001111111111111111111111111000000000000000000000000000000000
000000000000000001111111111111111111111111000000000000000000000000000000000
000000000000000001111111111111111111111111000000000000000000000000000000000
000000000000000001111111111111111111111111000000000000000000000000000000000
000000000000000001111111111111111111111111000000000000000000000000000000000
000000000000000001111111111111111111111111000000000000000000000000000000000
000000000000000001111111111111111111111111000000000000000000000000000000000
000000000000000001111111111111111111111111000000000000000000000000000000000
